{
  "contacts": {
    "C001": 6,
    "C002": 7,
    "C003": 8,
    "C004": 9,
    "C005": 10,
    "C006": 11,
    "C007": 12,
    "C008": 13,
    "C009": 14,
    "C010": 15,
    "C011": 16,
    "C012": 17,
    "C013": 18,
    "C014": 19,
    "C015": 20,
    "C016": 21,
    "C017": 22,
    "C018": 23,
    "C019": 24,
    "C020": 25,
    "C021": 26,
    "C022": 27,
    "C023": 28,
    "C024": 29,
    "C025": 30,
    "C026": 31,
    "C027": 4,
    "C028": 32,
    "C029": 33,
    "C030": 34,
    "C031": 35,
    "C032": 36,
    "C033": 37,
    "C034": 38,
    "C035": 39,
    "C036": 40,
    "C037": 41,
    "C038": 42,
    "C039": 43,
    "C040": 44,
    "C041": 45,
    "C042": 46,
    "C043": 47,
    "C044": 48,
    "C045": 49,
    "C046": 50,
    "C047": 51,
    "C048": 52,
    "C049": 53,
    "C050": 54,
    "C051": 55,
    "C052": 56,
    "C053": 57,
    "C054": 5,
    "C055": 58,
    "C056": 59,
    "C057": 60,
    "C058": 61,
    "C059": 62,
    "C060": 63,
    "C061": 64,
    "C062": 65,
    "C063": 66,
    "C064": 67,
    "C065": 68,
    "C066": 69,
    "C067": 70,
    "C068": 71,
    "C069": 72,
    "C070": 73,
    "C071": 74,
    "C072": 75,
    "C073": 76,
    "C074": 77
  },
  "funders": {
    "F001": 1,
    "F002": 2,
    "F003": 3,
    "F004": 4,
    "F005": 5,
    "F006": 6,
    "F007": 7,
    "F008": 8,
    "F009": 9
  }
}